########
#<^>v  #
#rfdt  #
#ybgh  #
#p;l'  #
#R     #
#      #
########
r