########
#t     #
###    #
#h     #
###    #
#'     #
#####  #
#R<<   #
########
rrrbbbppp
