########
#t     #
###    #
#h     #
####   #
#'     #
#####  #
#R<<   #
########
rbprbprbp
