t    ###
#### ###
t    >>v
#######R
#######R
t    >>^
#### ###
t    ###
rrrrrbbbbbo
