############
#rrr#bb#;;;#
#   #  #   #
#          #
#   ####   #
#          #
#          #
#          #
########   #
#R         #
############
rrrbbbppprrr
