r>>>v>>R
###v####
r>>>v>>R
###v####
b>>>v>>R
###v####
b>>>v>>R
########
rrrbbb
