r   > > > > R  
# # # # > # #  
r   >   >   #  
r   > # # # #  
# # # > # # #  
b   v   b   #  
b   v   b   #  
b   v   b   R  
rrrbbb
