t>>> >>R
#### ###
t>>> >>R
#### ###
t>>> >>R
#### ###
t>>> >>R
########
rrrbbb
