t    ###
#### ###
t    >>^
#######R
t    >>v
#### ###
t    ###
########
rrrrrrrrrrrrrro
