r>>>^>>>R
####^####
f>>>^>>>R
####^####
b>>>^>>>R
####^####
b>>>^>>>R
########
rrrbbb
