t    ###
#### ###
t    >>^
#######R
h    >>v
#### ###
h    ###
########
rrrbbb
