#########
# r # R #
#   # vv#
#   #   #
#^^ #vv # 
#   >   #
# vv#vvv#
#   #   #
#   <   #
# p # y #
#########
rrrbbbppp
