t    ###
#### ###
t    >>v
#######R
h    >>^
#### ###
h    ###
########
rrrbbb
