t>>> ###
#### ###
t>>> >>R
########
h>>> >>R
#### ###
h>>> ###
########
rrrbbb
