#############
#g   #;#   d#
#    # #    #
#^  ^# # v<<#
#    # ##v ^#
###  #   >^ #
#v<<#####   #
#v ^##R## ^^#
#> ^##^##>  #
#           #
#############
rrppbbpp
