r   > > > > > R  
    ^ # # # # #  
b   v   b   # #  
b   v   b   # R  
b   v   b   # #  
# # > # # # # #  
p   > > > > > R  
# # # # # # # #  
rrrbbbppp
