########
#y####;#
# #### #
# #### #
#      #
# #### #
# #### #
#f####R#
########
rrrbbbpppo
