###########
#t   #R   #
#    #vv  #
#^^^ #    #
#    >    #
#    #vvvv#
# vvv#    #
#    #    #
#    <    #
#p   #   y#
###########
rrrbbbppp
