#####Rb#
#  ##  #
#  ##  #
#      #
#  ##  #
#  ##  #
#  ##  #
#fR#####
rrrrbbbbo
