########
#b####;#
# #### #
# #### #
#      #
# #### #
# #### #
#r####R#
########
rrrbbbpppo
