#####Rb#
#  ##  #
#  ##  #
#      #
#  ##  #
#  ##  #
#  ##  #
#rR#####
rrrrbbbbo
