#############
#R<<<#     g#
#### # ######
#>>> >>>>>>v#
#^#########v#
#^#########v#
#^#########v#
#^<<<<<<<<<<#
###### ######
#t          #
#############
rrrrbbbbo
