###R###
#>> >v#
#^###v#
#^###v#
#^###v#
'^<<<<g
###y###
rrrrbbbbppppo
