#############
#          t#
#           #
#>>>>> >>>>>#
#^#########v#
#^#########v#
#^#########v#
#<<<<< <<<<<#
#           #
#f          #
#############
rrrrbbbbbo
