#########
#t  #  g#
#   #   #
#   <   #
# ##### #
# #     #
# # ### #
# #R# < #
# ###v# #
#       #
#########
rrbbrrbb0
