#########
#t #;# g#
#  # #  #
#  <<   #
# ##### #
# #     #
# # ### #
# #R# < #
# ###v# #
#       #
#########
bbbbpppprrrro
