###R#;#
#>> >v#
#^###v#
#^###v#
#^###v#
#^<<<<#
#f###y#
rrrrbbbbppppo
