#############
#R<<<#     g#
#### # ######
#>>> >>>>>>v#
#^#########v#
#^#########v#
#^#########v#
#^<<<<<<<<<<#
##### # #####
#t    #    l#
#############
rrrrbbbbppppo
