#############
#R<<<#     b#
#### # ######
#>>> >>>>>>v#
#^#########v#
#^#########v#
#^#########v#
#^<<<< <<<<<#
###### ######
#f          #
#############
rrrrbbbbbo
