#################
# rrr  bbb  ;;; #
#               #
#v############### 
#v###>>>>>>>>>>v#     
#v###^#########v#
#v###^#########v#
#v###^#########v#
#v>>>^#########v#
###############v#
#v<<<           #
#v  ^           #
#v  ^           #
#>>>^           #
#               #
#               #
#               #
#################
rbppbrrbpbrprbp

