##############
#g   #;#   d #
#    # #     #
#^  ^# #  v<<#
#    #    v ^#
### ######> ^#
#   #####    #
#>>v##R##    #
#^ v##^##    #
#^ <##^## ^^^#
#   ## ##    #
#            #
##############
##############
rrbbppbbbbbbbb
