###R###
#>> >v#
#^###v#
#^g#tv#
#^#:#v#
#^<<<<#
#######
rrrrbbbbppppo
