###R###
#>> >v#
#^###v#
#^###v#
#^###v#
#^<<<<#
#r#y#p#
rrrrbbbbppppo
