#R<##;#
#> >>v#
#^###v#
#^###v#
#^###v#
#^<<<<#
#r###y#
rrrrbbbbppppo
