#R<<##r#
###^## #
##> >>v#
##^###v#
##^###v#
##^###v#
##^<<<<#
#h ###p# 
rrrrbbbbppppo
