R<<<#  d
###^# ##
#>> >>v#
#^####v#
#^####v#
#^####v#
#^<<<<<#
h^####^l
rrrrbbbbppppo
