###########
#t  #;#  g#
#   # #   #
#   < >   #
# ####### #
# ###R### #
# ### ### #
# > # # < #
# #v# #v# #
#         #
###########
bbbbpppprrrro
