####^#########
# r ^ bb # ; >
<   ^    >   >
< #>^<<v<<<< #
< #   #  #   #
< # # #v##   #
<   #    #   #
##v##    # >>>
#>>v<<<< #   #
#^ v#    # ###
#^<<#    #  >>
# ### ##### v#
>R<   #v<<# v#
^######v#^# v#
^<<     #   v#
prrpbbprrbbbpr
